/languages/aai	Arifama-Miniafia (aai)
/languages/aak	Ankave (aak)
/languages/aar	Qafar (aar)
/languages/aau	Abau (aau)
/languages/aaz	Amarasi (aaz)
/languages/abm	Abanyom (abm)
/languages/abn	Abua (abn)
/languages/abp	Ayta, Abellen (abp)
/languages/abs	Ambong (abs)
/languages/abt	Ambulas (abt)
/languages/abx	Inabaknon (abx)
/languages/aby	Aneme Wake (aby)
/languages/aca	Achagua (aca)
/languages/acd	Gikyode (acd)
/languages/ace	Aceh (ace)
/languages/acf	Saint Lucian Creole French (acf)
/languages/ach	Lwo (ach)
/languages/acn	Ngochang (acn)
/languages/acr	Achi&#x27; (acr)
/languages/acu	Achuar (acu)
/languages/ada	Adangme (ada)
/languages/adh	Adhola (adh)
/languages/adi	Adi (adi)
/languages/adj	Adjukru (adj)
/languages/adl	Galo (adl)
/languages/ady	Адыгабзэ (ady)
/languages/adz	Adzera (adz)
/languages/aeb	العربية التونسية (aeb)
/languages/aer	Eastern Arrernte (aer)
/languages/aeu	Gaolkheel (aeu)
/languages/aey	Amele (aey)
/languages/afr	Afrikaans (afr)
/languages/agd	Agarabi (agd)
/languages/agg	Angor (agg)
/languages/agm	Angaataha (agm)
/languages/agn	Agutaynen (agn)
/languages/agq	Aghem (agq)
/languages/agr	Aguaruna (agr)
/languages/ags	Esimbi (ags)
/languages/agt	Central Cagayan Agta (agt)
/languages/agu	Qa&#x27;yol (agu)
/languages/agw	Anganiwai (agw)
/languages/agx	агъул чӀал (agx)
/languages/ahk	Akha (ahk)
/languages/ahr	Ahirani (ahr)
/languages/aia	Arosi (aia)
/languages/aii	ܐܬܘܪܝܐ ܣܘܪܝܝܐ (aii)
/languages/aim	Aimol (aim)
/languages/ain	Ainu (Japan) (ain)
/languages/aji	Waawilûû (aji)
/languages/ajz	Amri Karbi (ajz)
/languages/akb	Batak Angkola (akb)
/languages/ake	Akawaio (ake)
/languages/akh	Angal Heneng (akh)
/languages/akp	Siwu (akp)
/languages/ald	Alladian (ald)
/languages/alf	Elige (alf)
/languages/aln	Shqip: Geg (aln)
/languages/alp	Alune (alp)
/languages/alq	Anicinabemowin (alq)
/languages/alt	Алтай тил (alt)
/languages/aly	Alyawarr (aly)
/languages/alz	Lur (alz)
/languages/ame	Yanesha&#x27; (ame)
/languages/amh	አማርኛ (amh)
/languages/ami	&#x27;Amis (ami)
/languages/amk	Ambai (amk)
/languages/amm	Ama (PNG) (amm)
/languages/amn	Amanab (amn)
/languages/amp	Alamblak (amp)
/languages/amr	Amarakaeri (amr)
/languages/amu	Amuzgo (amu)
/languages/amx	Anmatyerre (amx)
/languages/anh	Nend (anh)
/languages/anm	Anal (anm)
/languages/ann	Obolo (ann)
/languages/anu	Anyuak (anu)
/languages/anv	Denya (anv)
/languages/any	Anyin (any)
/languages/aoi	Anindilyakwa (aoi)
/languages/aoj	Mufian (aoj)
/languages/aom	Ömie (aom)
/languages/aon	Bumbita Arapesh (aon)
/languages/aoz	Uab Meto (aoz)
/languages/apb	Sa&#x27;a (apb)
/languages/apc	Arabic, North Levantine (apc)
/languages/apd	لهجة سودانية (apd)
/languages/ape	Bukiyip (ape)
/languages/apn	Apinayé (apn)
/languages/apr	Arop-Lokep (apr)
/languages/apt	Apatani (apt)
/languages/apu	Apurinã (apu)
/languages/apw	Western Apache (apw)
/languages/apy	Apalaí (apy)
/languages/apz	Safeyoka (apz)
/languages/arb	العربية (arb)
/languages/arl	Arabela (arl)
/languages/arn	Mapudungun (arn)
/languages/arp	Arapaho (arp)
/languages/arq	Arabic, Algerian (arq)
/languages/ary	الدارجة المغربية (ary)
/languages/arz	اللغة المصرية العامية (arz)
/languages/asa	Chasu (asa)
/languages/asc	Casuarina Coast Asmat (asc)
/languages/asg	Cishingini (asg)
/languages/asm	অসমীয়া (asm)
/languages/aso	Dano (aso)
/languages/ata	Pele-Ata (ata)
/languages/atb	Zaiwa (atb)
/languages/atd	Ata Manobo (atd)
/languages/atg	Okphela (atg)
/languages/atj	Atikamekw (atj)
/languages/atm	Ata (atm)
/languages/atq	Aralle-Tabulahan (atq)
/languages/att	Pamplona Atta (att)
/languages/aty	Anejom̃ (aty)
/languages/auc	Waorani (auc)
/languages/aui	Anuki (aui)
/languages/auu	Auye (auu)
/languages/auy	Awiyaana (auy)
/languages/ava	Магӏарул (ava)
/languages/avn	Avatime (avn)
/languages/avt	Au (avt)
/languages/avu	Avokaya (avu)
/languages/awa	Awadhi (awa)
/languages/awb	Awa (PNG) (awb)
/languages/awx	Awara (awx)
/languages/ayh	Hadrami Arabic (ayh)
/languages/ayo	Ayoreo (ayo)
/languages/ayr	Aymar (ayr)
/languages/ayz	Mai Brat (ayz)
/languages/azb	آذری (azb)
/languages/azg	San Pedro Amuzgos Amuzgo (azg)
/languages/azj	Azərbaycanca (azj)
/languages/azo	Awing (azo)
/languages/azz	Highland Puebla Nahuatl (azz)
/languages/bak	Башҡортча (bak)
/languages/ban	Bali, basa (ban)
/languages/bao	Waimaha (bao)
/languages/bap	Bantawa (bap)
/languages/bav	Vengo (bav)
/languages/bba	Baatonum (bba)
/languages/bbb	Barai (bbb)
/languages/bbc	Batak Toba (bbc)
/languages/bbj	Ghomálá&#x27; (bbj)
/languages/bbk	Babanki (bbk)
/languages/bbr	Girawa (bbr)
/languages/bcc	Balóchi (bcc_rom)
/languages/bcc	بلوچی‎ (bcc)
/languages/bch	Bariai (bch)
/languages/bci	Baoulé (bci)
/languages/bcl	Central Bikol (bcl)
/languages/bcn	Bali (Nigeria) (bcn)
/languages/bco	Kaluli (bco)
/languages/bcw	Bana (bcw)
/languages/bcy	Bacama (bcy)
/languages/bdd	Bunama (bdd)
/languages/bdh	Baka (Sudan) (bdh)
/languages/bdq	Bahnar (bdq)
/languages/bds	Burunge (bds)
/languages/bdv	Bodo Parja (bdv)
/languages/bea	Dane-zaa (bea)
/languages/bef	Benabena (bef)
/languages/bel	беларуская (bel)
/languages/bem	Chibemba (bem)
/languages/ben	বাংলা (ben)
/languages/beo	Beami (beo)
/languages/bep	Besoa (bep)
/languages/beq	KiBeembe (beq)
/languages/bet	Bété, Guiberoua (bet)
/languages/bex	Jur Modo (bex)
/languages/bez	Bena (bez)
/languages/bfa	Kutuk (bfa)
/languages/bfb	Bareli, Pauri (bfb)
/languages/bfd	Bafut (bfd)
/languages/bfm	Mmen (bfm)
/languages/bfo	Birifor, Malba (bfo)
/languages/bfy	Bagheli (bfy)
/languages/bfz	Pahari, Mahasu (bfz)
/languages/bgc	Haryanvi (bgc)
/languages/bgg	Bugun (bgg)
/languages/bgq	Bagri (bgq)
/languages/bgr	Bawm (bgr)
/languages/bgs	Tagabawa (bgs)
/languages/bgt	Bughotu (bgt)
/languages/bgz	Banggai (bgz)
/languages/bhd	Bhadrawahi (bhd)
/languages/bhg	Binandere (bhg)
/languages/bhl	Bimin (bhl)
/languages/bho	भोजपुरी (bho)
/languages/bhp	Bima (bhp)
/languages/bht	Bhattiyali (bht)
/languages/bhw	Biak (bhw)
/languages/bib	Bissa (bib)
/languages/big	Biangai (big)
/languages/bim	Bimoba (bim)
/languages/bis	Bislama (bis)
/languages/biu	Biate (biu)
/languages/biv	Southern Birifor (biv)
/languages/bjk	Barok (bjk)
/languages/bjn	Banjar (bjn)
/languages/bjp	Fanamaket (bjp)
/languages/bjr	Binumarien (bjr)
/languages/bjv	Nangnda (bjv)
/languages/bjz	Baruga (bjz)
/languages/bkd	Binukid (bkd)
/languages/bkh	Bakoko (bkh)
/languages/bki	Baki (bki)
/languages/bkl	Berik (bkl)
/languages/bkq	Bakairí (bkq)
/languages/bkw	Bekwel (bkw)
/languages/bky	Bokyi (bky)
/languages/bla	Siksiká (bla)
/languages/blb	Bilua (blb)
/languages/blr	Plang (blr)
/languages/blt	Tai Dam (blt)
/languages/blw	Balangao (blw)
/languages/blx	Ayta, Mag-Indi (blx)
/languages/blz	Balantak (blz)
/languages/bmh	Kein (bmh)
/languages/bmk	Ghayavi (bmk)
/languages/bmo	Bambalang (bmo)
/languages/bmr	Muinane (bmr)
/languages/bmu	Somba-Siawari (bmu)
/languages/bmv	Bum (bmv)
/languages/bni	Bobangi (bni)
/languages/bnj	Tawbuid, Eastern (bnj)
/languages/bno	Bantoanon (bno)
/languages/bnp	Bola Bakovi (bnp)
/languages/bns	Bundeli (bns)
/languages/boa	Bora (boa)
/languages/bod	བོད་ཡིག (bod)
/languages/boj	Anjam (boj)
/languages/bom	Berom (bom)
/languages/bon	Bine (bon)
/languages/bor	Borôro (bor)
/languages/bov	Tuwuli (bov)
/languages/box	Bwamu (box)
/languages/bpr	Koronadal Blaan (bpr)
/languages/bps	Sarangani Blaan (bps)
/languages/bpx	Bareli, Palya (bpx)
/languages/bqc	Boko (bqc)
/languages/bqj	Bandial (bqj)
/languages/bqp	Busa (bqp)
/languages/brb	Brao (brb)
/languages/bre	Brezhoneg (bre)
/languages/bri	Mokpwe (bri)
/languages/bru	Van Kieu (bru)
/languages/brv	Bru, Western (brv)
/languages/bsc	Oniyan (bsc)
/languages/bsn	Barasana-Eduria (bsn)
/languages/bsp	Baga Sitemu (bsp)
/languages/bsq	Bassa (bsq)
/languages/bss	Akoose (bss)
/languages/bst	ባስኬቶኛ (bst)
/languages/btd	Pakpak (btd)
/languages/bth	Biatah Bidayuh (bth)
/languages/bts	Batak Simalungun (bts)
/languages/btx	Batak Karo (btx)
/languages/bud	Ntcham (bud)
/languages/bug	Bugis (bug)
/languages/buk	Bugawac (buk)
/languages/bul	български (bul)
/languages/bum	Bulu (Cameroon) (bum)
/languages/bun	Bolom (bun)
/languages/bus	Bokobaru (bus)
/languages/buu	Budu (buu)
/languages/bux	Boghom (bux)
/languages/buy	Mani (buy)
/languages/bvd	Baeggu (bvd)
/languages/bvr	Burarra (bvr)
/languages/bwo	Borna (bwo)
/languages/bwr	Bura-Pabir (bwr)
/languages/bwu	Buli (Ghana) (bwu)
/languages/bxk	Luluhia (bxk)
/languages/bxr	буряад (bxr)
/languages/byr	Baruya (byr)
/languages/byv	Medumba (byv)
/languages/byx	Qaqet (byx)
/languages/bza	Gbandi (bza)
/languages/bzd	Bribri (bzd)
/languages/bzh	Mapos Buang (bzh)
/languages/bzi	Bisu (bzi)
/languages/bzj	Bileez Kriol (bzj)
/languages/bzw	Rubassa (bzw)
/languages/caa	Chortí (caa)
/languages/cab	Karif (cab)
/languages/cac	Chuj (cac)
/languages/caf	ᑕᗸᒡ (caf)
/languages/cag	Niwaklé (cag)
/languages/cak	Kakchikel (cak)
/languages/cam	Cemuhî (cam)
/languages/cao	Chácobo (cao)
/languages/cap	Puquina (cap)
/languages/caq	Car Nicobarese (caq)
/languages/car	Carib (car)
/languages/cas	Tsimané (cas)
/languages/cat	Català (cat)
/languages/cav	Cavineña (cav)
/languages/cax	Besiro (Chiquitano) (cax)
/languages/cbc	Carapana (cbc)
/languages/cbi	Chachi (cbi)
/languages/cbk	Chavacano (cbk)
/languages/cbr	Cashibo-Cacataibo (cbr)
/languages/cbs	Cashinahua (cbs)
/languages/cbt	Chayahuita (cbt)
/languages/cbu	Candoshi-Shapra (cbu)
/languages/cbv	Cacua (cbv)
/languages/cce	Chopi (cce)
/languages/cco	Comaltepec Chinantec (cco)
/languages/ccp	Chakma (ccp)
/languages/cdh	Chambeali (cdh)
/languages/cdj	Churahi (cdj)
/languages/ceb	Cebuano (ceb)
/languages/cek	Lemi (cek)
/languages/ces	Čeština (ces)
/languages/cfm	Falam (cfm)
/languages/cgc	Kagayanen (cgc)
/languages/chd	Highland Oaxaca Chontal (chd)
/languages/che	Нохчийн мотт (che)
/languages/chf	Tabasco Chontal (chf)
/languages/chj	Ojitlán Chinantec (chj)
/languages/chk	Chuukese (chk)
/languages/chn	Chinuk Wawa (chn)
/languages/cho	Chahta (cho)
/languages/chq	Quiotepec Chinantec (chq)
/languages/chr	ᏣᎳᎩ ᎦᏬᏂᎯᏍᏗ (chr)
/languages/chv	Чӑвашла (chv)
/languages/chz	Ozumacín Chinantec (chz)
/languages/cje	Chru (cje)
/languages/cjk	Chokwe (cjk)
/languages/cjo	Ashéninka Pajonal (cjo)
/languages/cjv	Chuave (cjv)
/languages/ckb	کوردیی سۆرانی (ckb)
/languages/cko	Anufo (cko)
/languages/cky	Cakfem-Mushere (cky)
/languages/cla	Ron (cla)
/languages/cle	Chinantec Lealao (cle)
/languages/clt	Lautu Chin (clt)
/languages/clu	Caluyanun (clu)
/languages/cme	Cerma (cme)
/languages/cmi	Emberá-Chamí (cmi)
/languages/cmo	Bunong (cmo)
/languages/cmr	Mro-Khimi Chin (cmr)
/languages/cnh	Hakha (cnh)
/languages/cni	Asháninka (cni)
/languages/cnk	Khumi Chin (cnk)
/languages/cnl	Lalana Chinantec (cnl)
/languages/cns	Central Asmat (cns)
/languages/cnt	Tepetotutla Chinantec (cnt)
/languages/cnw	Ngawn Chin (cnw)
/languages/coe	Koreguaje (coe)
/languages/cof	Colorado (cof)
/languages/cok	Santa Teresa Cora (cok)
/languages/con	Cofán (con)
/languages/cop	ϯⲙⲉⲧⲣⲉⲙⲛ̀ⲭⲏⲙⲓ (cop)
/languages/cor	Kernewek (cor)
/languages/cos	Corsu (cos)
/languages/cot	Caquinte (cot)
/languages/cou	Wamey (cou)
/languages/cpa	Chinantec Palantla (cpa)
/languages/cpb	Ucayali-Yurúa Ashéninka (cpb)
/languages/cpc	Ajyíninka Apurucayali (cpc)
/languages/cpu	Ashéninka Pichis (cpu)
/languages/cpy	South Ucayali Ashéninka (cpy)
/languages/crh	Къырымтатарджа (crh)
/languages/crj	Īnū Ayimūn (crj)
/languages/crk	ᓀᐦᐃᔭᐍᐏᐣ (crk)
/languages/crl	ᐄᔨᔫ ᐊᔨᒨᓐ (crl)
/languages/crm	 ᐃᓕᓖᒧᐎᓐ (crm)
/languages/crn	Cora El Nayar (crn)
/languages/crs	Seselwa Creole French (crs)
/languages/crt	Chorote (crt)
/languages/crx	Dakelh (crx)
/languages/csk	Jola-Kasa (csk)
/languages/cso	Sochiapam Chinantec (cso)
/languages/csy	Chin: Siyin (csy)
/languages/cta	Tataltepec Chatino (cta)
/languages/ctd	Chin: Tedim (ctd)
/languages/cto	Emberá-Catío (cto)
/languages/ctp	Western Highland Chatino (ctp)
/languages/ctu	Chol (ctu)
/languages/cub	Cubeo (cub)
/languages/cuc	Usila Chinantec (cuc)
/languages/cug	Chungmboko (cug)
/languages/cui	Cuiba (cui)
/languages/cuk	Kuna San Blas (cuk)
/languages/cul	Culina (cul)
/languages/cut	Teutila Cuicatec (cut)
/languages/cuv	Cuvok (cuv)
/languages/cux	Tepeuxila Cuicatec (cux)
/languages/cwa	Kabwa (cwa)
/languages/cwe	Ching&#x27;hwele (cwe)
/languages/cya	Nopala Chatino (cya)
/languages/cym	Cymraeg (cym)
/languages/czt	Zotung Chin (czt)
/languages/daa	Dangaléat (daa)
/languages/dad	Marik (dad)
/languages/daf	Dan (daf)
/languages/dag	Dagbani (dag)
/languages/dah	Gwahatike (dah)
/languages/dak	Dakhótiyapi (dak)
/languages/dan	Dansk (dan)
/languages/dao	Chin, Daai (dao)
/languages/dav	Taita (dav)
/languages/ded	Dedua (ded)
/languages/des	Desano (des)
/languages/deu	Deutsch (deu)
/languages/dga	Dagaare (dga)
/languages/dgc	Casiguran Dumagat Agta (dgc)
/languages/dgi	Dagra (dgi)
/languages/dgo	Dogri (dgo)
/languages/dgr	Tłı̨chǫ Yatıì (dgr)
/languages/dgz	Daga (dgz)
/languages/dhd	Dhundari (dhd)
/languages/dhg	Dhangu (dhg)
/languages/dhi	Dhimal (dhi)
/languages/dhm	Dhimba (Zemba, Oludhimba) (dhm)
/languages/dhn	Dhanki (dhn)
/languages/dib	Dinka Ciec (dib)
/languages/did	Didinga (did)
/languages/dif	Diyari (dif)
/languages/dig	Chidigo (dig)
/languages/dik	Dinka Rek (dik)
/languages/dip	Northeastern Dinka (dip)
/languages/diq	Zazaki, Southern (diq)
/languages/dis	Dimasa (dis)
/languages/div	divehi (div)
/languages/dji	Djinang (dji)
/languages/djk	Businenge Tongo (djk)
/languages/djr	DjambarrpuyÅ‹gu (djr)
/languages/dks	Dinka Bor (dks)
/languages/dna	Upper Grand Valley Dani (dna)
/languages/dni	Dani, Lower Grand Valley (dni)
/languages/dnj	Dan (Blowo) (dnj)
/languages/dnt	Mid Grand Valley Dani (dnt)
/languages/dnw	Western Dani (dnw)
/languages/dob	Dobu (PNG) (dob)
/languages/dow	Doyayo (dow)
/languages/dru	Ngudradrekai (dru)
/languages/dsh	Daasanach (dsh)
/languages/dso	Desiya (dso)
/languages/dtb	Kadazan, Labuk-Kinabatangan (dtb)
/languages/dtp	Boros Dusun (dtp)
/languages/dty	Dotyali (dty)
/languages/dub	Dubli (dub)
/languages/due	Umiray Dumaget Agta (due)
/languages/dug	Duruma (dug)
/languages/duo	Dupaninan Agta (duo)
/languages/dur	Dii (dur)
/languages/dwr	Dawro (dwr)
/languages/dww	Dawawa (dww)
/languages/dwy	Dhuwaya (dwy)
/languages/dyi	Sénoufo, Djimini (dyi)
/languages/dyu	Dyula (dyu)
/languages/dzo	རྫོང་ཁ (dzo)
/languages/ebk	Eastern Bontok (ebk)
/languages/ebr	Ebrié (ebr)
/languages/ebu	Embu (ebu)
/languages/efi	Efik (efi)
/languages/ego	Eggon (ego)
/languages/eka	Ekajuk (eka)
/languages/ekg	Ekari (ekg)
/languages/ekk	Eesti (ekk)
/languages/eko	Koti (eko)
/languages/eky	Kayah, Eastern (eky)
/languages/ell	Ελληνικά (ell)
/languages/emi	Mussau-Emira (emi)
/languages/emp	Northern Emberá (emp)
/languages/ena	Apalɨ (ena)
/languages/eng	English (eng)
/languages/enq	Enga (enq)
/languages/enx	Enxet (enx)
/languages/epo	Esperanto (epo)
/languages/erg	Sie (erg)
/languages/eri	Ogea (eri)
/languages/ese	Ese Ejja (ese)
/languages/esg	Aheri Gondi (esg)
/languages/esi	Iñupiaq (esi)
/languages/esk	Inupiatun Northwest Alaska (esk)
/languages/ess	Юпик (ess)
/languages/esu	Yup&#x27;ik (esu)
/languages/etn	Eton (etn)
/languages/etr	Edolo (etr)
/languages/etu	Ejagham (etu)
/languages/etx	Eten (etx)
/languages/eus	Euskara (eus)
/languages/eve	Эвэды төрэн (eve)
/languages/ewe	eʋegbe (ewe)
/languages/ewo	Ewondo (ewo)
/languages/eza	Ezaa (eza)
/languages/faa	Fasu (faa)
/languages/fad	Wagi (fad)
/languages/fai	Faiwol (fai)
/languages/fao	Føroyskt (fao)
/languages/far	Fataleka (far)
/languages/fat	Fanti (fat)
/languages/ffm	Fulfulde (Burkina Faso) (ffm_ltbf)
/languages/ffm	Fulfulde (Maasinankoore) (ffm)
/languages/fia	Fiadidja Nubian (fia)
/languages/fij	Vosa Vakaviti (fij)
/languages/fin	Suomi (fin)
/languages/fip	Fipa (fip)
/languages/flr	Fuliiru (flr)
/languages/fmu	Muria, Far Western (fmu)
/languages/fon	Fon (fon)
/languages/for	Fore (for)
/languages/fra	Français (fra)
/languages/frd	Fordata (frd)
/languages/frr	Freesk (frr)
/languages/fub	Fulfulde (Adamawa) (fub)
/languages/fub	ڢُلْڢُلْدٜ عَدَمَوَ (fub_ar)
/languages/fud	Futuna, East (fud)
/languages/fue	Fulfulde, Borgu (fue)
/languages/fuf	Pular (fuf)
/languages/fuh	Fulfulde (Western Niger) (fuh)
/languages/fuq	Fulfulde (Central-Eastern Niger) (fuq)
/languages/fur	Furlan (fur)
/languages/fut	Futuna-Aniwa (fut)
/languages/fuv	Fulfulde Caka Nigeria Arabic Script (fuv_ar)
/languages/fuv	Fulfulde Caka Nigeria (fuv)
/languages/gaa	Gã (gaa)
/languages/gag	Гагаузча /Gagauzca (gag)
/languages/gah	Alekano (gah)
/languages/gai	Mborena Kam (gai)
/languages/gam	Kandawo (gam)
/languages/gaq	Gata’ (gaq)
/languages/gas	Garasia, Adiwasi (gas)
/languages/gau	Gadaba, Mudhili (gau)
/languages/gaw	Nobonob (gaw)
/languages/gax	gujii (gax)
/languages/gaz	West Central Oromo (gaz)
/languages/gbi	Galela (gbi)
/languages/gbk	Gaddi (gbk)
/languages/gbl	Gamit (gbl)
/languages/gbm	Garhwali (gbm)
/languages/gbo	Grebo, Northern (gbo)
/languages/gbr	Gbagyi (gbr)
/languages/gcr	Guianese Creole French (gcr)
/languages/gde	Gude (gde)
/languages/gdg	Ga&#x27;dang (gdg)
/languages/gdn	Umanakaina (gdn)
/languages/gdr	Wipi (gdr)
/languages/geb	Kire (geb)
/languages/gej	Mina (gej)
/languages/gek	Yiwom (gek)
/languages/gez	ግዕዝ (gez)
/languages/gfk	Patpatar (gfk)
/languages/ggw	Gogodala (ggw)
/languages/ghe	Ghale (ghe)
/languages/ghs	Guhu-Samane (ghs)
/languages/gid	Gidar (gid)
/languages/gil	Kiribati (gil)
/languages/giz	South Giziga (giz)
/languages/gjn	Gonja (gjn)
/languages/gkp	Kpèlèè (gkp)
/languages/gla	Gàidhlig (gla)
/languages/gle	Gaeilge (cló Gaelach) (gle_gl)
/languages/gle	Gaeilge (gle)
/languages/glg	Galego (glg)
/languages/glk	گیلکی (glk)
/languages/glv	Gaelg (glv)
/languages/gmv	Gamo (gmv)
/languages/gna	Kaansa (gna)
/languages/gnb	Gangte (gnb)
/languages/gnd	Zulgo-Gemzek (gnd)
/languages/gng	Ngangam (gng)
/languages/gnn	Gumatj (gnn)
/languages/gnw	Guaraní: Simba (gnw)
/languages/goa	Guro (goa)
/languages/god	Godié (god)
/languages/gof	Goofa (gof)
/languages/gog	Gogo (gog)
/languages/gok	Gowli (gok)
/languages/gol	Gola (gol)
/languages/gom	Konkani (gom)
/languages/gor	Gorontalo (gor)
/languages/gqr	Gor (gqr)
/languages/grc	Ελληνιστική Κοινή (grc)
/languages/gri	Ghari (gri)
/languages/grt	Garo (grt)
/languages/gso	Southwest Gbaya (gso)
/languages/gub	Guajajára (gub)
/languages/guc	Wayuu (guc)
/languages/gud	Dida (gud)
/languages/gue	Gurinji (gue)
/languages/gug	Guaraní paraguayo (gug)
/languages/guh	Guahibo (guh)
/languages/gui	Guaraní: Ava (Bolivia) (gui)
/languages/guj	ગુજરાતી (guj)
/languages/gul	Gullah (gul)
/languages/gum	Guambiano (gum)
/languages/gun	Mbyá Guaraní (gun)
/languages/guo	Guayabero (guo)
/languages/gup	Kunwinjku (gup)
/languages/gur	Farefare (gur)
/languages/guu	Yanomamö (guu)
/languages/guw	Gun-Alada (guw)
/languages/gux	Gourmanchéma (gux)
/languages/guz	Ekegusii (guz)
/languages/gvc	Wanano (gvc)
/languages/gvf	Golin (gvf)
/languages/gvl	Gulay (gvl)
/languages/gvn	Kuku-Yalanji (gvn)
/languages/gvr	Gurung (gvr)
/languages/gvs	Gumawana (gvs)
/languages/gwi	Gwichʼin (gwi)
/languages/gwr	Gwere (gwr)
/languages/gya	Northwest Gbaya (gya)
/languages/gym	Ngäbere (gym)
/languages/gyr	Guarayu (gyr)
/languages/gyz	Geji (gyz)
/languages/had	Hatam (had)
/languages/hag	Hanga (hag)
/languages/hak	Hakkafa (Roman script) (hak_rom)
/languages/hak	客家話‎ (Hakkafa) (hak)
/languages/hap	Hupla (hap)
/languages/hat	Kreyòl Ayisyen (hat)
/languages/hau	Hausa (hau)
/languages/haw	Hawaiian (haw)
/languages/hay	Haya (hay)
/languages/hbb	Nya Huba (hbb)
/languages/hbn	Heiban (hbn)
/languages/hbo	עִבְרִית קְלַסִית‎ (hbo)
/languages/hch	Huichol (hch)
/languages/hdn	X̱aat Kíl (hdn)
/languages/hdy	Hadiyya (hdy)
/languages/heb	עברית (heb)
/languages/heg	Helong (heg)
/languages/heh	Kihehe (heh)
/languages/her	Herero (her)
/languages/hif	Hindi, Fiji (hif)
/languages/hil	Ilonggo (hil)
/languages/hin	Hindi (Roman Script) (hin_ro)
/languages/hin	हिन्दी (hin)
/languages/hix	Hixkaryána (hix)
/languages/hla	Halia (hla)
/languages/hlb	Halbi (hlb)
/languages/hlt	Matu Chin (hlt)
/languages/hmo	Hiri Motu (hmo)
/languages/hmr	Hmar (hmr)
/languages/hne	Chhattisgarhi (hne)
/languages/hnj	Hmong Hoa (hnj)
/languages/hns	Sarnami (hns)
/languages/hop	Hopi (hop)
/languages/hot	Hote (hot)
/languages/hoy	Holiya (hoy)
/languages/hra	Hrangkhol (hra)
/languages/hre	Hre (hre)
/languages/hrv	Hrvatski (hrv)
/languages/hto	Minica Huitoto (hto)
/languages/hub	Huambisa (hub)
/languages/hui	Huli (hui)
/languages/hun	Magyar (hun)
/languages/hus	Huastec (hus)
/languages/huu	Murui Huitoto (huu)
/languages/huv	Ikootz (huv)
/languages/hvn	Sabu (hvn)
/languages/hwc	Hawaii Pidgin (hwc)
/languages/hye	հայերեն (արևելահայերեն) (hye)
/languages/hyw	հայերէն (Արեւմտահայերէն) (hyw)
/languages/iai	Iaai (iai)
/languages/ian	Iatmul (ian)
/languages/iba	Iban (iba)
/languages/ibb	Ibibio (ibb)
/languages/ibl	Ibaloi (ibl)
/languages/ibo	Igbo (ibo)
/languages/icr	Islander Creole English (icr)
/languages/idu	Idoma (idu)
/languages/ifa	Amganad Ifugao (ifa)
/languages/ifb	Batad Ifugao (ifb)
/languages/ife	Ifè (ife)
/languages/ifk	Tuwali Ifugao (ifk)
/languages/ifu	Mayoyao Ifugao (ifu)
/languages/ify	Antipolo Ifugao (ify)
/languages/igb	Ebira (igb)
/languages/ige	Igede (ige)
/languages/igl	Igala (igl)
/languages/ign	Moxos (ign)
/languages/iii	ꆈꌠꉙ (iii)
/languages/ijn	Kalabari (ijn)
/languages/ike	ᐃᓄᒃᑎᑐᑦ (ike)
/languages/ike	ᓄᓇᕗᒻᒥᐅᑦ (ike_lab)
/languages/ikk	Ika (ikk)
/languages/iko	Olulumo-Ikom (iko)
/languages/ikt	Inuinnaqtun (ikt)
/languages/ikw	Ikwere (ikw)
/languages/ilb	Ila (ilb)
/languages/ilo	Ilokano (ilo)
/languages/imo	Imbongu (imo)
/languages/inb	Inga (inb)
/languages/ind	Bahasa Indonesia (ind)
/languages/ino	Inoke-Yate (ino)
/languages/iou	Tuma-Irumu (iou)
/languages/ipi	Ipili (ipi)
/languages/iqw	Ikwo (iqw)
/languages/iri	Rigwe (iri)
/languages/irk	Iraqw (irk)
/languages/isd	Isnag (isd)
/languages/isl	Íslenska (isl)
/languages/ita	Italiano (ita)
/languages/ium	ภาษาอิวเมี่ยน (ium)
/languages/ivb	Ibatan (ivb)
/languages/ivv	Ivatan (ivv)
/languages/iws	Sepik Iwam (iws)
/languages/ixl	Ixil (ixl)
/languages/iyx	Yaka (iyx)
/languages/izr	Izere (izr)
/languages/izz	Izii (izz)
/languages/jaa	Jamamadí (jaa)
/languages/jaa	Jarawara (jaa_jar)
/languages/jab	Hyam (jab)
/languages/jac	Popti&#x27; (jac)
/languages/jam	Jamiekan (jam)
/languages/jao	Yanyuwa (jao)
/languages/jav	Basa Jawa (jav)
/languages/jbn	Nafusi (jbn)
/languages/jer	Jere (jer)
/languages/jgk	Gwak (jgk)
/languages/jgo	Ngomba (jgo)
/languages/jib	Jibu (jib)
/languages/jic	Tol (jic)
/languages/jit	Jita (jit)
/languages/jiv	Shuar (jiv)
/languages/jmc	Machame (jmc)
/languages/jmx	Mixtec, Western Juxtlahuaca (jmx)
/languages/jpn	日本語 (jpn)
/languages/jra	Jarai (jra)
/languages/juy	Juray (juy)
/languages/jvn	Basa Jawa Suriname (jvn)
/languages/kaa	Qaraqalpaqsha (Қарақалпақша) (kaa)
/languages/kac	Jingpho (kac)
/languages/kaj	Jju (kaj)
/languages/kam	Kamba (Kenya) (kam)
/languages/kan	ಕನ್ನಡ (kan)
/languages/kap	бежкьалас миц (kap)
/languages/kaq	Capanahua (kaq)
/languages/kat	ქართული (kat)
/languages/kaz	Қазақша / Qazaqşa / قازاق ٴتىلى (kaz)
/languages/kbc	Kadiwéu (kbc)
/languages/kbd	адыгэбзэ (къэбэрдейбзэ) (kbd)
/languages/kbh	Camsá (kbh)
/languages/kbm	Iwal (kbm)
/languages/kbn	Kare (kbn)
/languages/kbo	Keliko (kbo)
/languages/kbp	Kabiyè (kbp)
/languages/kbq	Kamano (kbq)
/languages/kbr	Kafa (kbr)
/languages/kby	Manga Kanuri (kby)
/languages/kca	ханты ясаң (kca)
/languages/kcg	Tyap (kcg)
/languages/kck	Kalanga (kck)
/languages/kdc	King&#x27;hutu (kdc)
/languages/kde	Chimakonde (kde)
/languages/kde	Shimakonde (kde_mz)
/languages/kdh	Tem (kdh)
/languages/kdi	Kumam (kdi)
/languages/kdj	Ng’akarimojong (kdj)
/languages/kdl	Tsikimba (kdl)
/languages/kdn	Kunda (kdn)
/languages/kdt	Kui (Kuy) (kdt)
/languages/ked	Kikerewe (Kerewe) (ked)
/languages/kek	Kekchí (kek)
/languages/ken	Kenyang (ken)
/languages/keo	Kakwa (keo)
/languages/ker	Kera (ker)
/languages/kew	West Kewa (kew)
/languages/key	Kupia (key)
/languages/kfa	Kodava (kfa)
/languages/kfc	Konda-Dora (kfc)
/languages/kff	Koya (kff)
/languages/kfi	Kurumba, Kannada (kfi)
/languages/kfp	Korwa (kfp)
/languages/kfs	Bilaspuri (kfs)
/languages/kfw	Naga, Kharam (kfw)
/languages/kfx	Pahari, Kullu (kfx)
/languages/kfy	Kumaoni (kfy)
/languages/kgf	Kube (kgf)
/languages/kgk	Kaiwá (kgk)
/languages/kgp	Kaingang (kgp)
/languages/kgr	Abun (kgr)
/languages/kha	Khasi (kha)
/languages/khk	Монгол (khk)
/languages/khm	ភាសាខ្មែរ (khm)
/languages/khs	Kasua (khs)
/languages/kht	Khamti (kht)
/languages/khy	Lokele (khy)
/languages/khz	Keapara (PNG) (khz)
/languages/kia	Kim (kia)
/languages/kij	Kilivila (kij)
/languages/kik	Gĩkũyũ (Gikuyu) (kik)
/languages/kin	Kinyarwanda (kin)
/languages/kir	Кыргыз тили (kir)
/languages/kiu	Kirmancki (kiu)
/languages/kiw	Kiwai, Northeast (kiw)
/languages/kix	Khiamniungan Naga (kix)
/languages/kjb	Q&#x27;anjob&#x27;al (kjb)
/languages/kje	Kisar (kje)
/languages/kjh	Хакас тілі (kjh)
/languages/kji	Zabana (kji)
/languages/kjl	Kham, Western Parbate (kjl)
/languages/kjs	East Kewa (kjs)
/languages/kkc	Odoodee (kkc)
/languages/kki	Kagulu (kki)
/languages/kkj	Kako (kkj)
/languages/kln	Kalenjin (kln)
/languages/klt	Nukna (klt)
/languages/klu	Klao (klu)
/languages/klv	Maskelynes (klv)
/languages/kma	Konni (kma)
/languages/kmb	Kimbundu (kmb)
/languages/kmh	Kalam (kmh)
/languages/kmk	Limos Kalinga (kmk)
/languages/kml	Kalinga, Tanudan (kml)
/languages/kmm	Komrem (kmm)
/languages/kmo	Kwoma (kmo)
/languages/kmr	Kurmancî (kmr)
/languages/kmr	کورمانجی (kmr_kur)
/languages/kms	Kamasau (kms)
/languages/kmu	Kanite (kmu)
/languages/kmw	Komo (kmw)
/languages/knb	Lubuagan Kalinga (knb)
/languages/kne	Kankanaey (kne)
/languages/knf	Mankanya (knf)
/languages/knj	Western Kanjobal (knj)
/languages/knk	Kuranko (knk)
/languages/kno	Kono (Sierra Leone) (kno)
/languages/knv	Tabo (knv)
/languages/kog	Cogui (kog)
/languages/koq	Kota (Gabon) (koq)
/languages/kor	한국어 (kor)
/languages/kos	Kosraean (kos)
/languages/kpf	Likɔɔnl (kpf)
/languages/kpg	Kapingamarangi (kpg)
/languages/kpj	Karajá (kpj)
/languages/kpm	Koho (kpm)
/languages/kpr	Korafe-Yegha (kpr)
/languages/kpw	Kobon (kpw)
/languages/kpx	Mountain Koiali (kpx)
/languages/kqa	Mum (kqa)
/languages/kqc	Doromu-Koki (kqc)
/languages/kqe	Kalagan (kqe)
/languages/kqf	Kakabai (kqf)
/languages/kql	Kiañiŋ Balaŋ (kql)
/languages/kqn	Kaonde (kqn)
/languages/kqo	Tchien Krahn (kqo)
/languages/kqp	Kimré (kqp)
/languages/kqs	Kisiei (kqs)
/languages/kqw	Kandas (kqw)
/languages/kqy	Koorete (kqy)
/languages/krc	Къарачай-Малкъар тил (krc)
/languages/kri	Krio (kri)
/languages/krj	Kinaray-A (krj)
/languages/krr	Krung (krr)
/languages/krs	Gbaya (Sudan) (krs)
/languages/kru	Kurux (kru)
/languages/krw	Western Krahn (krw)
/languages/krx	Karon (krx)
/languages/ksb	Kishambala (ksb)
/languages/ksc	Southern Kalinga (ksc)
/languages/ksf	Bafia (ksf)
/languages/ksj	Uare (ksj)
/languages/ksp	Kabba (ksp)
/languages/ksr	Borong (ksr)
/languages/kss	Kisi (kss)
/languages/ksw	ကညီကျိာ် (ksw)
/languages/ksz	Kodaku (ksz)
/languages/ktj	Plapo Krumen (ktj)
/languages/ktm	Kurti (ktm)
/languages/kto	Kuot (kto)
/languages/ktu	Kikwango (ktu)
/languages/kua	Oshikwanyama (Kwanyama) (kua)
/languages/kub	Kutep (kub)
/languages/kud	&#x27;Auhelawa (kud)
/languages/kue	Kuman (kue)
/languages/kuj	Kuria (kuj)
/languages/kum	къумукъ (kum)
/languages/kup	Kunimaipa (kup)
/languages/kus	Kusaal (kus)
/languages/kvg	Kuni-Boazi (kvg)
/languages/kvj	Psikye (kvj)
/languages/kvn	Dulegaya (kvn)
/languages/kvq	Karen, Geba (kvq)
/languages/kvy	Yintale (kvy)
/languages/kwd	Kwaio (kwd)
/languages/kwf	Kwara&#x27;ae (kwf)
/languages/kwi	Awa-Cuaiquer (kwi)
/languages/kwj	Kwanga (kwj)
/languages/kwk	Kwak&#x27;wala (kwk)
/languages/kxf	Manumanaw (kxf)
/languages/kxp	Koli, Wadiyara (kxp)
/languages/kxv	କୁଭି, କୁୱି (kxv)
/languages/kxw	Konai (kxw)
/languages/kxz	Kerewo (Goaribari) (kxz)
/languages/kyb	Butbut Kalinga (kyb)
/languages/kyc	Kyaka (kyc)
/languages/kyf	Kouya (kyf)
/languages/kyg	Keyagana (kyg)
/languages/kyj	Karao (kyj)
/languages/kyq	Kenga (kyq)
/languages/kyu	Kaya Western (kyu)
/languages/kyv	Kayort (kyv)
/languages/kyz	Kayabí (kyz)
/languages/kze	Kosena (kze)
/languages/kzf	Da&#x27;a Kaili (kzf)
/languages/kzr	Karang (kzr)
/languages/lac	Lacandon (lac)
/languages/lai	Lambya (lai)
/languages/laj	Lango (laj)
/languages/lam	Ichilamba (lam)
/languages/lao	ລາວ (lao)
/languages/lap	Laka (Chad) (lap)
/languages/lat	Latina (lat)
/languages/lbb	Label (lbb)
/languages/lbj	ལ་དྭགས་སྐད་ (lbj)
/languages/lbk	Central Bontok (lbk)
/languages/lbm	Lodhi (lbm)
/languages/lbr	Lohorung (lbr)
/languages/lcm	Tungag (lcm)
/languages/lcp	Western Lawa (lcp)
/languages/leb	Lala-Bisa (leb)
/languages/lee	Lyélé (lee)
/languages/lef	Lelemi (lef)
/languages/leg	Enhlit (Enhlet) (leg)
/languages/leh	Lenje (leh)
/languages/lem	Nomaande (lem)
/languages/leu	Kara (PNG) (leu)
/languages/lew	Ledo Kaili (lew)
/languages/lex	Luang (lex)
/languages/lez	лезги чӏал (lez)
/languages/lgg	Lugbara (lgg)
/languages/lgl	Wala (lgl)
/languages/lgm	Lega-Mwenga (lgm)
/languages/lhi	Lahu Shi (lhi)
/languages/lhu	Lahu (lhu)
/languages/lia	West-Central Limba (lia)
/languages/lid	Nyindrou (lid)
/languages/lif	Limbu (Devanagari) (lif_dev)
/languages/lif	Limbu (lif)
/languages/lik	Lika (lik)
/languages/lin	Lingala (lin)
/languages/lip	Sekpele (lip)
/languages/lis	Lisu (lis)
/languages/lit	Lietuvių (lit)
/languages/lje	Rampi (lje)
/languages/ljp	Lampung Api (ljp)
/languages/lkt	Lakȟótiyapi (lkt)
/languages/llb	Mazu Otchena (llb)
/languages/lle	Lele (lle)
/languages/llp	Nguna (llp)
/languages/llu	Lau (llu)
/languages/lmd	Lumun (lmd)
/languages/lme	Lamé (lme)
/languages/lmk	Lamkang (lmk)
/languages/lml	Hano (lml)
/languages/lmp	Limbum (lmp)
/languages/lnd	Lun Bawang (lnd)
/languages/lnl	Banda, South Central (lnl)
/languages/lno	Laŋo (lno)
/languages/lns	Lamnso’ (lns)
/languages/lob	Lobi (lob)
/languages/loe	Saluan (loe)
/languages/log	Logo (log)
/languages/lol	Mongo-Nkundu (lol)
/languages/lom	Loma (Liberia) (lom)
/languages/lon	Ellomwe (lon)
/languages/loq	Lobala (loq)
/languages/lot	Latuka (lot)
/languages/loz	Lozi (loz)
/languages/lpo	Eastern Lisu (lpo)
/languages/lro	Laro (lro)
/languages/lsi	Lashi (lsi)
/languages/lsm	Saamia (lsm)
/languages/ltg	Latgalīšu volūda (ltg)
/languages/lto	Tsotso (lto)
/languages/lua	Tshiluba (lua)
/languages/luc	Aringa (luc)
/languages/lue	Luvale (lue)
/languages/lug	Luganda (lug)
/languages/lun	Lunda (lun)
/languages/luo	Dholuo (luo)
/languages/lus	Mizo ṭawng (lus)
/languages/lvs	Latviešu Valoda (lvs)
/languages/lwg	Wanga (lwg)
/languages/lwo	Luwo (lwo)
/languages/lww	Lewo (lww)
/languages/lzh	文言（中文） (lzh)
/languages/lzz	Laz (lzz)
/languages/maa	San Jerónimo Tecóatl Mazatec (maa)
/languages/mad	Madurese (mad)
/languages/maf	Mafa (maf)
/languages/mai	Maithili (mai)
/languages/maj	Jalapa De Díaz Mazatec (maj)
/languages/mak	Makasar (mak)
/languages/mal	മലയാളം (mal)
/languages/mam	Mam (mam)
/languages/maq	Chiquihuitlán Mazatec (maq)
/languages/mar	मराठी (mar)
/languages/mas	Maasai (mas)
/languages/mau	Huautla Mazatec (mau)
/languages/mav	Sateré-Mawé (mav)
/languages/maw	Mampruli (maw)
/languages/max	Bahasa Melayu Maluku Utara (max)
/languages/maz	Central Mazahua (maz)
/languages/mbb	Western Bukidnon Manobo (mbb)
/languages/mbc	Macushi (mbc)
/languages/mbd	Dibabawon Manobo (mbd)
/languages/mbh	Mangseng (mbh)
/languages/mbi	Ilianen Manobo (mbi)
/languages/mbj	Nadëb (mbj)
/languages/mbl	Maxakalí (mbl)
/languages/mbs	Sarangani Manobo (mbs)
/languages/mbt	Matigsalug Manobo (mbt)
/languages/mbu	Mbula (mbu)
/languages/mca	Maca (mca)
/languages/mcb	Machiguenga (mcb)
/languages/mcd	Sharanahua (mcd)
/languages/mcf	Matsés (mcf)
/languages/mch	Maquiritari (mch)
/languages/mck	Mbunda (mck)
/languages/mcn	Masana (mcn)
/languages/mco	Mixe: Coatlán (mco)
/languages/mcp	Makaa (mcp)
/languages/mcq	Ese (mcq)
/languages/mcr	Menya (mcr)
/languages/mcu	Cameroon Mambila (mcu)
/languages/mda	Mada (mda)
/languages/mdm	Mayogo (mdm)
/languages/mdt	Mbere (mdt)
/languages/mdy	Maale (mdy)
/languages/med	Melpa (med)
/languages/mee	Mengen (mee)
/languages/meh	Mixtec, Southwestern Tlaxiaco (meh)
/languages/mek	Mekeo (mek)
/languages/men	Mɛnde yia (men)
/languages/meq	Merey (meq)
/languages/mer	Kimîîru (mer)
/languages/met	Mato (met)
/languages/mev	Mann (mev)
/languages/mfe	Morisyen (mfe)
/languages/mfg	Mogofin (mfg)
/languages/mfh	Matal (mfh)
/languages/mfi	Wandala (mfi)
/languages/mfk	North Mofu (mfk)
/languages/mfn	Mbembe, Cross River (mfn)
/languages/mfq	Moba (mfq)
/languages/mfv	Mandjak (mfv)
/languages/mfy	Mayo (mfy)
/languages/mfz	Mabaan (mfz)
/languages/mgc	Morokodo (mgc)
/languages/mge	Mango (mge)
/languages/mgg	Mpumpong (mgg)
/languages/mgh	Makua (mgh)
/languages/mgj	Abureni (mgj)
/languages/mgm	Mambae (mgm)
/languages/mgo	Meta&#x27; (mgo)
/languages/mgp	Magar, Eastern (mgp)
/languages/mgq	Malila (mgq)
/languages/mgr	Mambwe-Lungu (mgr)
/languages/mgw	Matumbi (mgw)
/languages/mhi	Ma&#x27;diti (mhi)
/languages/mhl	Mauwake (mhl)
/languages/mhq	Nų́ų́ʔetaa íroo (mhq)
/languages/mhx	Lhao Vo (mhx)
/languages/mhy	Ma&#x27;anyan (mhy)
/languages/mib	Atatláhuca Mixtec (mib)
/languages/mic	Mi&#x27;kmaq (mic)
/languages/mie	Ocotepec Mixtec (mie)
/languages/mif	Mofu-Gudur (mif)
/languages/mig	San Miguel El Grande Mixtec (mig)
/languages/mih	Chayuco Mixtec (mih)
/languages/mil	Peñoles Mixtec (mil)
/languages/mim	Alacatlatzala Mixtec (mim)
/languages/mio	Pinotepa Nacional Mixtec (mio)
/languages/miq	Miskito (miq)
/languages/mir	Isthmus Mixe (mir)
/languages/mis	Uncoded languages (mis)
/languages/mit	Southern Puebla Mixtec (mit)
/languages/miy	Ayutla Mixtec (miy)
/languages/miz	Coatzospan Mixtec (miz)
/languages/mjc	San Juan Colorado Mixtec (mjc)
/languages/mjl	Mandeali (mjl)
/languages/mjv	Mannan (mjv)
/languages/mjw	Karbi (mjw)
/languages/mkd	Македонски (mkd)
/languages/mkf	Miya (mkf)
/languages/mkl	Mokole (mkl)
/languages/mkn	Kupang Malay (mkn)
/languages/mks	Mixtec Silacayoapan (mks)
/languages/mle	Manambu (mle)
/languages/mlh	Mape (mlh)
/languages/mlp	Bargam (mlp)
/languages/mlr	Vame (mlr)
/languages/mlt	Malti (mlt)
/languages/mlu	To’abaita (mlu)
/languages/mmn	Mamanwa (mmn)
/languages/mmo	Mangga Buang (mmo)
/languages/mmp	Siawi (mmp)
/languages/mmx	Madak (mmx)
/languages/mmy	Migaama (mmy)
/languages/mna	Mbula (mna)
/languages/mnf	Mundani (mnf)
/languages/mnh	Mono (mnh)
/languages/mni	Meitei (mni)
/languages/mnk	Mandinka (mnk)
/languages/mnv	Rennell-Bellona (mnv)
/languages/mnx	Sougb (mnx)
/languages/moa	Mwan (moa)
/languages/moc	Mocoví (moc)
/languages/mog	Mongondow (mog)
/languages/moh	Kanien’kéha (moh)
/languages/mop	Mopán Maya (mop)
/languages/mos	Mossi (mos)
/languages/mox	Molima (mox)
/languages/moy	Shekkacho (moy)
/languages/moz	Mukulu (moz)
/languages/mpd	Machinere (mpd)
/languages/mpe	Majang (mpe)
/languages/mpg	Marba (mpg)
/languages/mph	Maung (mph)
/languages/mpm	Yosondúa Mixtec (mpm)
/languages/mpp	Migabac (mpp)
/languages/mps	Dadibi (mps)
/languages/mpt	Mian (mpt)
/languages/mpx	Misima-Panaeati (mpx)
/languages/mqb	Mbuko (mqb)
/languages/mqj	Mamasa (mqj)
/languages/mqy	Manggarai (mqy)
/languages/mrg	Mising (mrg)
/languages/mri	Māori (mri)
/languages/mrn	Cheke Holo (mrn)
/languages/mrr	Maria (India) (mrr)
/languages/msa	Bahasa Melayu (msa)
/languages/msb	Masbatenyo (msb)
/languages/msc	Sankaran (msc)
/languages/mse	Musey (mse)
/languages/msk	Mansaka (msk)
/languages/msm	Agusan Manobo (msm)
/languages/msy	Aruamu (msy)
/languages/mta	Cotabato Manobo (mta)
/languages/mtg	Una (mtg)
/languages/mti	Maiwa (PNG) (mti)
/languages/mtl	Montol (mtl)
/languages/mto	Mixe: Totontepec (mto)
/languages/mtp	Wichí Lhamtés Nocten (mtp)
/languages/mtq	Muong (mtq)
/languages/mtr	Mewari (mtr)
/languages/mtt	Mota (Vanuatu) (mtt)
/languages/mua	Mundang (mua)
/languages/mug	Musgu (mug)
/languages/muh	Mündü (muh)
/languages/mur	Murle (mur)
/languages/muv	Muthuvan (muv)
/languages/mux	Bo-Ung (mux)
/languages/muy	Muyang (muy)
/languages/mva	Manam (mva)
/languages/mvn	Minaveha (mvn)
/languages/mvp	Duri (mvp)
/languages/mwc	Are (mwc)
/languages/mwe	Mwera (Chimwera) (mwe)
/languages/mwh	Mouk-Aria (mwh)
/languages/mwl	Mirandês (mwl)
/languages/mwm	Sar (mwm)
/languages/mwn	Chinamwanga (mwn)
/languages/mwp	Kala Lagaw Ya (mwp)
/languages/mwq	Mün Chin (mwq)
/languages/mws	Mwimbi-Muthambi (mws)
/languages/mwv	Mentawai (mwv)
/languages/mww	Hmong (mww)
/languages/mxb	Tezoatlán Mixtec (mxb)
/languages/mxp	Tlahuitoltepec Mixe (mxp)
/languages/mxq	Mixe: Juquila (mxq)
/languages/mxt	Jamiltepec Mixtec (mxt)
/languages/mxv	Metlatónoc Mixtec (mxv)
/languages/mxx	Mahou (mxx)
/languages/mya	မြန်မာယူနီကုတ် (mya)
/languages/mya	ျမန္မာေဇာ္ဂ်ီ (mya_zaw)
/languages/myb	Mbay (myb)
/languages/mye	Ômyèṉè (mye)
/languages/myk	Mamara Senoufo (myk)
/languages/myu	Mundurukú (myu)
/languages/myw	Muyuw (myw)
/languages/myx	Masaaba (myx)
/languages/myy	Macuna (myy)
/languages/mza	Santa María Zacatepec Mixtec (mza)
/languages/mzh	Wichí (mzh)
/languages/mzi	Ixcatlán Mazatec (mzi)
/languages/mzj	Manya (mzj)
/languages/mzl	Mixe: Mazatlán (mzl)
/languages/mzm	Mumuye (mzm)
/languages/mzn	Mazanderani (mzn)
/languages/mzw	Deg (mzw)
/languages/mzz	Maiadomu (mzz)
/languages/nab	Southern Nambikuára (nab)
/languages/naf	Nabak (naf)
/languages/nag	Naga Pidgin (nag)
/languages/nak	Nakanai (nak)
/languages/nan	Chinese, Min Nan (nan)
/languages/naq	Khoekhoegowab (naq)
/languages/nas	Naasioi (nas)
/languages/nav	Navajo (nav)
/languages/naw	Nawuri (naw)
/languages/nbc	Chang Naga (nbc)
/languages/nbe	Konyak Naga (nbe)
/languages/nbl	isiNdebele (nbl)
/languages/nbu	Rongmei Naga (nbu)
/languages/nca	Iyo (nca)
/languages/ncg	Nisga’a (ncg)
/languages/nch	Central Huasteca Nahuatl (nch)
/languages/ncj	Northern Puebla Nahuatl (ncj)
/languages/ncl	Michoacán Nahuatl (ncl)
/languages/ncq	Northern Katang (ncq)
/languages/nct	Chothe (nct)
/languages/ncu	Chumburung (ncu)
/languages/ndc	Ndau (ndc)
/languages/ndd	Nde-Nsele-Nta (ndd)
/languages/nde	isiNdebele (nde)
/languages/ndh	Ndali (ndh)
/languages/ndi	Samba Leko (ndi)
/languages/ndj	Ndamba (ndj)
/languages/ndo	OshiNdonga (ndo)
/languages/ndp	Ndo (ndp)
/languages/ndv	Ndut (ndv)
/languages/ndx	Nduga (ndx)
/languages/ndz	Ndogo (ndz)
/languages/new	Newar (new)
/languages/ney	Neyo (ney)
/languages/nfa	Dhao (nfa)
/languages/nga	Ngbaka (nga)
/languages/ngb	Northern Ngbandi (ngb)
/languages/ngc	Ngombe (ngc)
/languages/nge	Ngemba (nge)
/languages/ngj	Ngie (ngj)
/languages/ngl	Lomwe (ngl)
/languages/ngn	Ngwo (ngn)
/languages/ngp	Ngulu (ngp)
/languages/ngu	Guerrero Nahuatl (ngu)
/languages/nhe	Nahuat Eastern Huasteca (nhe)
/languages/nhg	Tetelcingo Nahuatl (nhg)
/languages/nhi	Nahuatl Zacatlán-Ahuacatlán-Tepetzintla (nhi)
/languages/nho	Takuu (nho)
/languages/nhr	Naro (nhr)
/languages/nhu	Noone (nhu)
/languages/nhw	Western Huasteca Nahuatl (nhw)
/languages/nhx	Isthmus-Mecayapan Nahuatl (nhx)
/languages/nhy	Northern Oaxaca Nahuatl (nhy)
/languages/nia	Li Niha (nia)
/languages/nif	Nek (nif)
/languages/nih	Nyiha, Tanzania (nih)
/languages/nii	Nii (nii)
/languages/nij	Ngaju (nij)
/languages/nim	Kĩnilyamba (nim)
/languages/nin	Ninzo (nin)
/languages/niy	Ngiti (niy)
/languages/njb	Nocte Naga (njb)
/languages/njm	Angami (njm)
/languages/njn	Liangmai Naga (njn)
/languages/njo	Ao Naga (njo)
/languages/njz	Nyishi (njz)
/languages/nka	Shinkoya (nka)
/languages/nki	Thangkhal (nki)
/languages/nko	Nkonya (nko)
/languages/nkr	Nukuoro (nkr)
/languages/nla	Ngombale (nla)
/languages/nlc	Nalca (nlc)
/languages/nld	Nederlands (nld)
/languages/nlg	Gela (nlg)
/languages/nlk	Ninia Yali (nlk)
/languages/nlx	Nahali (nlx)
/languages/nma	Maram Naga (nma)
/languages/nmf	Tangkhul (nmf)
/languages/nmh	Monsang Naga (nmh)
/languages/nmo	Moyon Naga (nmo)
/languages/nmw	Nimoa (nmw)
/languages/nnb	Ndandi (nnb)
/languages/nnd	Havakinau (nnd)
/languages/nng	Maring Naga (nng)
/languages/nnh	Ngyemboon (Ngiemboon) (nnh)
/languages/nnl	Rengma Naga (North) (nnl)
/languages/nno	Norsk: nynorsk (nno)
/languages/nnp	Wancho Naga (nnp)
/languages/nnq	Ngindo (nnq)
/languages/nnw	Southern Nuni (nnw)
/languages/noa	Woun Meu (noa)
/languages/nob	Norsk: bokmål (nob)
/languages/nod	Northern Thai (nod)
/languages/nog	Ногай тили (nog)
/languages/noi	Noiri (noi)
/languages/nop	Numanggang (nop)
/languages/not	Nomatsiguenga (not)
/languages/nou	Ewage-Notu (nou)
/languages/nph	Phom Naga (nph)
/languages/npi	नेपाली (npi)
/languages/npl	Southeastern Puebla Nahuatl (npl)
/languages/npo	Pochuri (npo)
/languages/npy	Napu (npy)
/languages/nre	Rengma Naga (nre)
/languages/nrf	Guernésiais (nrf)
/languages/nri	Chakhesang Chokri (nri)
/languages/nsa	Sangtam Naga (nsa)
/languages/nse	Cinsenga (nse)
/languages/nsk	ᐃᔪᐤ ᐃᔨᒧᐅᓐ  (nsk)
/languages/nsm	Sumi Naga (nsm)
/languages/nsn	Nehan (nsn)
/languages/nso	Sesotho sa Leboa (nso)
/languages/nss	Nali (nss)
/languages/nst	Tangsa (nst)
/languages/nsu	Nahuatl (nsu)
/languages/ntk	Ikoma-Nata-Isenye (ntk)
/languages/ntp	Northern Tepehuan (ntp)
/languages/ntr	Delo (ntr)
/languages/ntu	Natqgu (ntu)
/languages/nuf	Nusu (nuf)
/languages/nuj	Nyole (nuj)
/languages/nuq	Nukumanu (nuq)
/languages/nus	Thok Naath (nus)
/languages/nut	Nung (nut)
/languages/nuy	Nunggubuyu (nuy)
/languages/nvm	Namiae (nvm)
/languages/nwb	Nyabwa (nwb)
/languages/nwi	Southwest Tanna (nwi)
/languages/nxd	Longando (nxd)
/languages/nxl	South Nuaulu (nxl)
/languages/nxq	Naxi (nxq)
/languages/nya	Chichewa (nya)
/languages/nyb	Tutrugbu (nyb)
/languages/nyd	Nyore (nyd)
/languages/nyf	Giryama (nyf)
/languages/nym	Nyamwezi (nym)
/languages/nyn	Nyankole (nyn)
/languages/nyo	Nyoro (nyo)
/languages/nys	Nyoongar (nys)
/languages/nyu	Nyungwe (nyu)
/languages/nyy	Nyakyusa-Ngonde (nyy)
/languages/nza	Tigon Mbembe (nza)
/languages/nzb	Yinzébi (nzb)
/languages/nzi	Nzima (nzi)
/languages/nzm	Zeme Naga (nzm)
/languages/obo	Obo Manobo (obo)
/languages/oci	Occitan (oci)
/languages/odu	Odual (odu)
/languages/ofu	Efutop (ofu)
/languages/ojb	Nakawēmowin (ojb)
/languages/okr	Kirike (okr)
/languages/oku	Oku (oku)
/languages/okv	Orokaiva (okv)
/languages/old	Mochi (old)
/languages/omb	East Ambae (omb)
/languages/omw	South Tairora (omw)
/languages/one	Oneida (one)
/languages/ong	Olo (ong)
/languages/ons	Ono (ons)
/languages/ood	Tohono O&#x27;odham (ood)
/languages/opm	Oksapmin (opm)
/languages/oro	Orokolo (PNG) (oro)
/languages/ory	ODIA (ory)
/languages/oss	ирон ӕвзаг (oss)
/languages/otd	Ot Danum (otd)
/languages/ote	Otomi Mezquital (ote)
/languages/otm	Eastern Highland Otomi (otm)
/languages/otn	Tenango Otomi (otn)
/languages/otq	Otom Querétaro (otq)
/languages/otr	Otoro (otr)
/languages/ots	Estado de México Otomi (ots)
/languages/oym	Wayampi (oym)
/languages/ozm	Koonzime (ozm)
/languages/pab	Parecís (pab)
/languages/pac	Pacoh (pac)
/languages/pad	Paumarí (pad)
/languages/pag	Pangasinan (pag)
/languages/pah	Tenharim (pah)
/languages/pam	Pampanga (pam)
/languages/pan	ਪੰਜਾਬੀ (pan)
/languages/pao	Northern Paiute (pao)
/languages/pap	Papiamentu (pap)
/languages/pbb	Páez (pbb)
/languages/pbc	Patamona (pbc)
/languages/pbu	Pashto, Northern (pbu)
/languages/pcc	Bo-Y (pcc)
/languages/pce	Palaung, Ruching (pce)
/languages/pck	Paite (pck)
/languages/pcm	Pidgin, Nigerian (pcm)
/languages/pdc	Pennsilfaanisch Deitsch (pdc)
/languages/pdt	Plautdietsch (pdt)
/languages/peg	Pengo (peg)
/languages/pes	فارسی (pes)
/languages/pfe	Peere (pfe)
/languages/pgg	Pangwali (pgg)
/languages/phr	Pahari-Potwari (phr)
/languages/pib	Yine (pib)
/languages/pio	Piapoco (pio)
/languages/pir	Piratapuyo (pir)
/languages/pis	Pijin (pis)
/languages/pjt	Pitjantjatjara (pjt)
/languages/pkb	Pokomo (pkb)
/languages/pko	Pökoot (pko)
/languages/pkr	Kurumba, Attapady (pkr)
/languages/plg	Pilagá (plg)
/languages/plj	Polci (plj)
/languages/pls	San Marcos Tlacoyalco Popoloca (pls)
/languages/plt	Malagasy (Madagascar) (plt)
/languages/plu	Palikúr (plu)
/languages/plw	Brooke&#x27;s Point Palawano (plw)
/languages/pma	Paama (pma)
/languages/pmf	Pamona (pmf)
/languages/pmx	Poumai Naga (pmx)
/languages/pmy	Malay, Papuan (pmy)
/languages/pnb	پن٘جابی (pnb)
/languages/pnb	پن٘جابی (pnb_rom)
/languages/pne	Nibong (pne)
/languages/pny	Pinyin (pny)
/languages/pnz	Pana (pnz)
/languages/poe	San Juan Atzingo Popoloca (poe)
/languages/poh	Poqomchi&#x27; (poh)
/languages/poi	Popoluca Highland (poi)
/languages/pol	Polski (pol)
/languages/pon	Pohnpeian (pon)
/languages/por	Português (Brasil) (por)
/languages/por	Português (Portugal) (por_pt)
/languages/pos	Sayula Popoluca (pos)
/languages/pot	Potawatomi (pot)
/languages/pov	Crioulo, Upper Guinea (pov)
/languages/poy	Shipogoro (poy)
/languages/ppk	Uma (ppk)
/languages/ppo	Folopa (ppo)
/languages/pps	Popoloca, San Luís Temalacayuca (pps)
/languages/pqm	Skicinuwatu (pqm)
/languages/prf	Paranan (prf)
/languages/pri	Paicî (pri)
/languages/prq	Ashéninka Perené (prq)
/languages/prs	دری‎ (prs)
/languages/prt	Prai (prt)
/languages/pse	Barisan (pse)
/languages/ptp	Patep (ptp)
/languages/ptu	Bambam (ptu)
/languages/pua	Western Highland Purepecha (pua)
/languages/puu	Yipunu (puu)
/languages/pwg	Gapapaiwa (pwg)
/languages/pwo	Pwo Western Karen (pwo)
/languages/pww	Karen, Northern Pwo (Thai Script) (pww)
/languages/pxm	Mixe: Quezaltepec (pxm)
/languages/pym	Fyam (pym)
/languages/pyy	Pyen (pyy)
/languages/qiq	illumiNations (qiq)
/languages/qub	Huallaga Huánuco Quechua (qub)
/languages/quc	K&#x27;iche&#x27; (quc)
/languages/quf	Lambayeque Quechua (quf)
/languages/qug	Kichwa: Chaupi urcucuna (qug)
/languages/quh	Uralan Buliwya runasimi (quh)
/languages/qul	North Bolivian Quechua (qul)
/languages/qup	Southern Pastaza Quechua (qup)
/languages/quy	Ayacucho Quechua (quy)
/languages/quz	Diospa simin qelqa (quz)
/languages/qva	Ambo-Pasco Quechua (qva)
/languages/qvc	Cajamarca Quechua (qvc)
/languages/qve	Eastern Apurímac Quechua (qve)
/languages/qvh	Huamalíes-Dos de Mayo Huánuco Quechua (qvh)
/languages/qvi	Kichwa: Imbabura (qvi)
/languages/qvm	Quechua Margos-Yarowilca-Lauricocha (qvm)
/languages/qvn	North Junín Quechua (qvn)
/languages/qvo	Quechua, Napo Lowland (qvo)
/languages/qvs	Quechua San Martín (qvs)
/languages/qvw	Quechua Huaylla Wanca (qvw)
/languages/qvz	Northern Pastaza Quichua (qvz)
/languages/qwa	Quechua, Corongo Ancash (qwa)
/languages/qwh	Huaylas Ancash Quechua (qwh)
/languages/qxh	Panao Huánuco Quechua (qxh)
/languages/qxl	Salasakaguna (qxl)
/languages/qxn	Huaylay (qxn)
/languages/qxo	Quechua Southern Conchucos Ancash (qxo)
/languages/qxr	Kichwa: Ura urcucuna (qxr)
/languages/rad	E-De (rad)
/languages/rag	Lulogooli (rag)
/languages/rai	Ramoaaina (rai)
/languages/ram	Canela (ram)
/languages/rap	Rapanui (rap)
/languages/rar	Māori Kūki &#x27;Āirani (rar)
/languages/rbb	Palaung, Rumai (rbb)
/languages/rej	Rejang (rej)
/languages/rel	Rendille (rel)
/languages/ria	Riang (India) (ria)
/languages/rif	Tarifit (rif)
/languages/rif	Tarifit (rif_arb)
/languages/ril	Riang (ril)
/languages/rim	Kirimi (rim)
/languages/rkb	Rikbaktsa (rkb)
/languages/rmc	Romani: Romanes (Karpatský) (rmc)
/languages/rme	Romany: Angloromani (rme)
/languages/rml	Romani: Baltic (rml)
/languages/rmn	Romani: Gurbeti Arlija (rmn_arl)
/languages/rmn	Romani: Ursari (rmn)
/languages/rmo	Romani: Sinte (rmo)
/languages/rmq	Romaní: Caló (Iberia) (rmq)
/languages/rmy	Romani: Kalderaš/căldărari (rmy_fr)
/languages/rmy	Romani: Lovari (rmy_lov)
/languages/rmy	Romani: Ursari (rmy)
/languages/rmy	Romani: Vlax chileana (rmy_ch)
/languages/rmy	Romani: Vlax (rmy_vax)
/languages/rmz	Marma (rmz)
/languages/rng	ShiRonga (rng)
/languages/rnl	Ranglong (rnl)
/languages/rol	Romblomanon (rol)
/languages/ron	Română (ron)
/languages/roo	Rotokas (roo)
/languages/rop	Kriol (rop)
/languages/rro	Waima (rro)
/languages/rub	Gungu (rub)
/languages/ruf	Chilughuru (ruf)
/languages/rug	Roviana (rug)
/languages/run	Ikirundi (run)
/languages/rup	Armãneashti/Arumanisht (rup)
/languages/rus	Русский (rus)
/languages/rut	мыхӀабишды чӀел (rut)
/languages/rwk	Rwa (rwk)
/languages/rwo	Rawa (rwo)
/languages/sab	Buglere (sab)
/languages/sag	Sängö (sag)
/languages/sah	Саха тыла (sah)
/languages/saj	Sahu (saj)
/languages/san	Saṃskṛtam (san)
/languages/saq	Samburu (saq)
/languages/sas	Sasak (sas)
/languages/sat	Santali (sat)
/languages/sav	Saafi-Saafi (sav)
/languages/saw	Sawi (saw)
/languages/sba	Ngambay (sba)
/languages/sbd	Samo, Southern (sbd)
/languages/sbe	Saliba (sbe)
/languages/sbk	Safwa (sbk)
/languages/sbl	Botolan Sambal (sbl)
/languages/sbp	Sangu (sbp)
/languages/sby	Soli (sby)
/languages/sch	Sakachep (sch)
/languages/scn	Sicilianu (scn)
/languages/sco	Lallans (sco)
/languages/sco	Ullans (sco_uls)
/languages/scp	Helambu Sherpa (scp)
/languages/sda	Toraja-Sa&#x27;dan (sda)
/languages/see	Onödowáʼga (see)
/languages/sef	Sénoufo, Cebaara (sef)
/languages/seh	Sena (seh)
/languages/ses	Songhai de Gao (ses)
/languages/set	Sentani (set)
/languages/sev	Sénoufo, Nyarafolo (sev)
/languages/sey	Secoya (sey)
/languages/sfw	Sehwi (sfw)
/languages/sgb	Mag-antsi Ayta (sgb)
/languages/sgj	Surgujia (sgj)
/languages/sgw	ሰባትቤት (sgw)
/languages/sgz	Sursurunga (sgz)
/languages/shi	Tachelhit (shi)
/languages/shj	Shatt (shj)
/languages/shk	Shilluk (shk)
/languages/shn	Shan (shn)
/languages/shp	Shipibo-Conibo (shp)
/languages/shu	Arabe tchadien (shu_rom)
/languages/shu	العربي الدارجي هنا تشاد (shu)
/languages/sia	Cа̄мь кӣлл (Аккала) (sia)
/languages/sid	Sidamo (sid)
/languages/sig	Paasaal (sig)
/languages/sil	Sisaala, Tumulung (sil)
/languages/sim	Mende (PNG) (sim)
/languages/sin	සිංහල (sin)
/languages/sja	Epena (sja)
/languages/sjd	Cа̄мь кӣлл (Kӣллт) (sjd)
/languages/sjm	Mapun (sjm)
/languages/slk	Slovenčina (slk)
/languages/sll	Salt-Yui (sll)
/languages/slm	Pangutaran Sama (slm)
/languages/slu	Selaru (slu)
/languages/slv	Slovenščina (slv)
/languages/smk	Binu-Bolinao (smk)
/languages/sml	Central Sama (sml)
/languages/smo	Gagana fa&#x27;a Sāmoa (smo)
/languages/sms	Cаме килле (Скольт) (sms)
/languages/smt	Simte (smt)
/languages/sna	chiShona (sna)
/languages/snc	Sinaugoro (snc)
/languages/snd	سنڌي (snd)
/languages/snf	Noon (snf)
/languages/snn	Siona (snn)
/languages/snp	Siane (snp)
/languages/snq	Sangu (snq)
/languages/snw	Selee (snw)
/languages/sny	Saniyo-Hiyewe (sny)
/languages/som	Soomaali (som)
/languages/sop	Luba-Kalebwe (sop)
/languages/soq	Kanasi (soq)
/languages/sor	Somrai (sor)
/languages/sot	Sesotho (sot)
/languages/soy	Miyobe (soy)
/languages/spa	Español (América Latina) (spa)
/languages/spa	Español (España) (spa_es)
/languages/spl	Selepet (spl)
/languages/spm	Akɨghɨman Akam (spm)
/languages/spp	Supyire Senoufo (spp)
/languages/sps	Saposa (sps)
/languages/sqi	Shqip (sqi)
/languages/sri	Siriano (sri)
/languages/srm	Saamáka (srm)
/languages/srn	Sranan Tongo (srn)
/languages/srp	Српски Srpski (srp)
/languages/srq	Sirionó (srq)
/languages/srx	Sirmauri (srx)
/languages/ssc	Suba-Simbiti (ssc)
/languages/ssd	Siroi (ssd)
/languages/ssg	Seimat (ssg)
/languages/ssw	siSwati (ssw)
/languages/ssx	Samberigi (ssx)
/languages/ssz	Sengseng (ssz)
/languages/stb	Subanen, Northern (stb)
/languages/stp	Southeastern Tepehuan (stp)
/languages/sua	Sulka (sua)
/languages/suc	Western Subanon (suc)
/languages/sue	Suena (sue)
/languages/suk	Sukuma (suk)
/languages/sun	Sundanese (sun)
/languages/sus	Sosoxui (sus)
/languages/sus	سٌسٌ (sus_ar)
/languages/suz	कोँइच (suz)
/languages/swc	Kiswahili: Congo (swc)
/languages/swe	Svenska (swe)
/languages/swh	Kiswahili (swh)
/languages/swj	Sira (swj)
/languages/swk	Malawi Sena (swk)
/languages/swv	Shekhawati (swv)
/languages/sxb	Suba (sxb)
/languages/sxn	Sangir (sxn)
/languages/syb	Central Subanen (syb)
/languages/syl	Sylheti Nagri (syl_nag)
/languages/syl	Sylheti (syl)
/languages/syw	Kagate (syw)
/languages/szb	Ngalum (szb)
/languages/szv	Isu (szv)
/languages/tab	табасаран чIал (tab)
/languages/tac	Lowland Tarahumara (tac)
/languages/taj	तामाङ (taj)
/languages/tam	தமிழ் (tam)
/languages/tan	Tangle (tan)
/languages/tao	Yami (tao)
/languages/taq	Tamasheq (taq)
/languages/tat	Татарча (tat)
/languages/tav	Tatuyo (tav)
/languages/taw	Tai (taw)
/languages/tbc	Takia (tbc)
/languages/tbf	Mandara (tbf)
/languages/tbg	North Tairora (tbg)
/languages/tbk	Calamian Tagbanwa (tbk)
/languages/tbl	Tboli (tbl)
/languages/tbo	Tawala (tbo)
/languages/tbw	Tagbanwa (tbw)
/languages/tca	Ticuna (tca)
/languages/tcc	Datooga (tcc)
/languages/tcd	Tafi (tcd)
/languages/tcs	Torres Strait Creole (tcs)
/languages/tcy	Tulu (tcy)
/languages/tcz	Thadou Kuki (tcz)
/languages/tdc	Emberá-Tadó (tdc)
/languages/tdg	Tamang, Western (tdg)
/languages/tdh	Thulung (tdh)
/languages/ted	Tepo Krumen (ted)
/languages/tee	Huehuetla Tepehua (tee)
/languages/teg	Teke-Tege (teg)
/languages/tel	తెలుగు (tel)
/languages/tem	Timne (tem)
/languages/teo	Teso (teo)
/languages/ter	Tereno (ter)
/languages/tet	Tetum Terik (tet)
/languages/tew	Tewa (USA) (tew)
/languages/tex	Tennet (tex)
/languages/tfr	Teribe (tfr)
/languages/tgj	Tagin (tgj)
/languages/tgk	тоҷикӣ (tgk)
/languages/tgl	Filipino (tgl)
/languages/tgo	Sudest (tgo)
/languages/tgp	Tangoa (tgp)
/languages/tgw	Sénoufo, Tagwana (tgw)
/languages/tha	ภาษาไทย (tha)
/languages/thk	Tharaka (thk)
/languages/thl	Tharu, Dangaura (thl)
/languages/thq	Tharu, Kochila (thq)
/languages/thv	Tamahaq (thv)
/languages/tif	Tifal (tif)
/languages/tih	Murut Timugon (tih)
/languages/tim	Timbe (tim)
/languages/tir	ትግርኛ (tir)
/languages/tiu	Adasen (tiu)
/languages/tiv	Tiv (tiv)
/languages/tiy	Tiruray (tiy)
/languages/tke	Takwane (tke)
/languages/tkl	Tokelau (tkl)
/languages/tkr	Tsakhur (tkr)
/languages/tku	Upper Necaxa Totonac (tku)
/languages/tlb	Tobelo (tlb)
/languages/tld	Talaud (tld)
/languages/tlf	Telefol (tlf)
/languages/tlj	Talinga-Bwisi (tlj)
/languages/tll	Tetela (tll)
/languages/tlm	Tolomako (tlm)
/languages/tmd	Haruai (tmd)
/languages/tml	Tamnim Citak (tml)
/languages/tna	Tacana (tna)
/languages/tnc	Tanimuca-Retuarã (tnc)
/languages/tnk	Kwamera (tnk)
/languages/tnn	North Tanna (tnn)
/languages/tnp	East Tanna (Vanuatu) (tnp)
/languages/tnr	Ménik (tnr)
/languages/tnt	Tontemboan (tnt)
/languages/tob	Toba Qom (tob)
/languages/toc	Coyutla Totonac (toc)
/languages/tod	Lɔɠɔma (tod)
/languages/tof	Gizrra (tof)
/languages/tog	chiTonga (tog)
/languages/toh	Gitonga (toh)
/languages/toi	chiTonga (toi)
/languages/toj	Tojolabal (toj)
/languages/tom	Tombulu (tom)
/languages/ton	lea fakatonga (ton)
/languages/too	Xicotepec De Juárez Totonac (too)
/languages/top	Papantla Totonac (top)
/languages/tos	Totonac Highland (tos)
/languages/tpa	Taupota (tpa)
/languages/tpi	Tok Pisin (tpi)
/languages/tpm	Tampulma (tpm)
/languages/tpp	Pisaflores Tepehua (tpp)
/languages/tpt	Tlachichilco Tepehua (tpt)
/languages/tpu	Tampuan (tpu)
/languages/tpx	Me’phaa, Acatepec (tpx)
/languages/tpz	Tinputz (tpz)
/languages/tqo	Toaripi (tqo)
/languages/trc	Copala Triqui (trc)
/languages/tro	Tarao (tro)
/languages/trp	Kokborok (trp)
/languages/trq	San Martín Itunyoso Triqui (trq)
/languages/trv	Truku (trv)
/languages/tsa	Tsaangi (tsa)
/languages/tsc	Tswa (tsc)
/languages/tsg	Tausug (tsg)
/languages/tsn	Setswana (tsn)
/languages/tso	Xitsonga (tso)
/languages/tsu	Tsou (tsu)
/languages/tsw	Tsishingini (tsw)
/languages/ttc	Tektiteko (ttc)
/languages/tte	Bwanabwana (tte)
/languages/ttq	Tawallammat Tamajaq (ttq)
/languages/ttr	Nyimatli (ttr)
/languages/tuc	Mutu (tuc)
/languages/tue	Tuyuca (tue)
/languages/tuf	Central Tunebo (tuf)
/languages/tui	Tupuri (tui)
/languages/tuk	Түркменче / Туркменский (Türkmençe) (tuk)
/languages/tuk	ترکمن (tuk_arb)
/languages/tul	Ki̱tule (tul)
/languages/tum	Tumbuka (tum)
/languages/tuo	Tucano (tuo)
/languages/tur	Türkçe (tur)
/languages/tuv	Turkana (tuv)
/languages/tvk	Southeast Ambrym (tvk)
/languages/tvl	Tuvalu (tvl)
/languages/tvs	Tubeta (KiTaveta) (tvs)
/languages/tvt	Tutsa Naga (tvt)
/languages/tvu	Tunen (tvu)
/languages/twb	Tawbuid (twb)
/languages/twi	Twi (twi)
/languages/twu	Termanu (twu)
/languages/txq	Tii (txq)
/languages/txt	Citak (txt)
/languages/txu	Kayapó (txu)
/languages/tyv	Тыва дыл (tyv)
/languages/tyy	Tiyaa (tyy)
/languages/tyz	Tày (tyz)
/languages/tzh	Tzeltal (tzh)
/languages/tzj	Tz&#x27;utujil (tzj)
/languages/tzo	Tzotzil (tzo)
/languages/ubr	Ubir (ubr)
/languages/ubu	Umbu-Ungu (ubu)
/languages/udg	Muduga (udg)
/languages/udi	Udi (udi)
/languages/udu	Uduk (udu)
/languages/uhn	Damal (uhn)
/languages/uig	Уйғурчә (uig_cyr)
/languages/uig	ئۇيغۇر تىلى‎ (uig)
/languages/ukk	Muak Sa-aak (ukk)
/languages/ukr	Українська (ukr)
/languages/uli	Ulithian (uli)
/languages/ulk	Meriam Mer (ulk)
/languages/umb	Umbundu (umb)
/languages/unx	Munda (unx)
/languages/upv	Uripiv-Wala-Rano-Atchin (upv)
/languages/ura	Urarina (ura)
/languages/urb	Urubú-Kaapor (urb)
/languages/urd	Urdū (urd_rom)
/languages/urd	اردو (urd)
/languages/urd	उर्दू (urd_dv)
/languages/urh	Urhobo (urh)
/languages/uri	Urim (uri)
/languages/urt	Urat (urt)
/languages/urw	Sob Dora (urw)
/languages/ury	Orya Papua (ury)
/languages/usa	Usarufa (usa)
/languages/usp	Uspanteco (usp)
/languages/uth	u̱t-Hun (uth)
/languages/uvh	Uri (uvh)
/languages/uvl	Lote (uvl)
/languages/uzn	Oʻzbekcha (Ўзбекча) (uzn)
/languages/vag	Vagla (vag)
/languages/vah	Varhadi-Nagpuri (vah)
/languages/vai	ꕙꔤ (vai)
/languages/vap	Vaiphei (vap)
/languages/var	Huarijio (var)
/languages/ven	Tshivenḓa (ven)
/languages/vid	Chividunda (vid)
/languages/vie	tiếng Việt (vie)
/languages/vif	Vili (vif)
/languages/viv	Iduna (viv)
/languages/vmk	Makua (vmk)
/languages/vmp	Mazatec, Soyaltepec (vmp)
/languages/vmy	Ayautla Mazatec (vmy)
/languages/vol	Volapük (vol)
/languages/vrs	Varisi (vrs)
/languages/vun	Kivunjo (vun)
/languages/vut	Vute (vut)
/languages/waj	Waffa (waj)
/languages/wal	Wolaytta (wal)
/languages/wap	Wapishana (wap)
/languages/war	Waray (Philippines) (war)
/languages/wat	Kaninuwa (wat)
/languages/wbi	Vwanji (wbi)
/languages/wbm	Wa (wbm)
/languages/wbp	Warlpiri (wbp)
/languages/wed	Wedau (wed)
/languages/weh	Weh (weh)
/languages/wer	Weri (wer)
/languages/whk	Wahau Kenyah (whk)
/languages/wib	Win (wib)
/languages/wim	Wik-Mungkan (wim)
/languages/win	Winnebego (win)
/languages/wiu	Wiru (wiu)
/languages/wji	Warji (wji)
/languages/wls	Faka &#x27;uvea (wls)
/languages/wlw	Walak (wlw)
/languages/wmt	Walmajarri (wmt)
/languages/wmw	Mwani (wmw)
/languages/wnc	Wantoat (wnc)
/languages/wno	Wano (wno)
/languages/wnu	Usan (wnu)
/languages/wob	Wè Northern (wob)
/languages/wof	Jolof (wof)
/languages/wol	Wolof (wol)
/languages/won	Wongo (won)
/languages/wos	Hanga Hundi (wos)
/languages/wpc	Maco (wpc)
/languages/wrk	Garrwa (wrk)
/languages/wrs	Waris (wrs)
/languages/wsg	Adilabad Gondi (wsg)
/languages/wtk	Watakataui (wtk)
/languages/wul	Silimo (wul)
/languages/wum	Wumbvu (wum)
/languages/wuv	Wuvulu-Aua (wuv)
/languages/xal	Хальмг келн (xal)
/languages/xan	ጫምታንግኛ (xan)
/languages/xav	Xavánte (xav)
/languages/xbi	Kombio (xbi)
/languages/xbr	Kambera (xbr)
/languages/xcl	հայերէն (xcl)
/languages/xdy	Malayic Dayak (xdy)
/languages/xed	Hdi (xed)
/languages/xho	isiXhosa (xho)
/languages/xis	Kisan (xis)
/languages/xla	Kamula (xla)
/languages/xmm	Malay, Manado (xmm)
/languages/xnj	Ngoni (Tanzania) (xnj)
/languages/xnn	Northern Kankanay (xnn)
/languages/xnr	Kangri (xnr)
/languages/xnz	Mattokki (xnz)
/languages/xog	Soga (xog)
/languages/xon	Konkomba (xon)
/languages/xpe	Kpelle Liberia (xpe)
/languages/xrb	Eastern Karaboro (xrb)
/languages/xsb	Sambal (xsb)
/languages/xsi	Sio (xsi)
/languages/xsm	Kasem (xsm)
/languages/xsn	Sanga (xsn)
/languages/xsr	Sherpa (xsr)
/languages/xsu	Sanumá (xsu)
/languages/xtc	Katcha-Kadugli-Miri (xtc)
/languages/xtd	Diuxi-Tilantongo Mixtec (xtd)
/languages/xte	Ketengban (xte)
/languages/xtm	Magdalena Peñasco Mixtec (xtm)
/languages/xtn	Northern Tlaxiaco Mixtec (xtn)
/languages/xuo	Kuo (xuo)
/languages/yaa	Yaminahua (yaa)
/languages/yac	Pass Valley Yali (yac)
/languages/yad	Yagua (yad)
/languages/yae	Pumé (yae)
/languages/yal	Yalunka (yal)
/languages/yam	Yamba (yam)
/languages/yan	Mayangna (yan)
/languages/yao	Yawo (Yaawo) (yao)
/languages/yap	Yapese (yap)
/languages/yaq	Yaqui (yaq)
/languages/yas	Nugunu (yas)
/languages/yat	Yambeta (yat)
/languages/yba	Yala (yba)
/languages/ybb	Yemba (ybb)
/languages/yby	Yaweyuha (yby)
/languages/ycn	Yucuna (ycn)
/languages/ydd	ייִדיש (ydd)
/languages/yea	Ravula (yea)
/languages/yij	Yindjibarndi (yij)
/languages/yim	Yimchungru Naga (yim)
/languages/yka	Yakan (yka)
/languages/yle	Yele (yle)
/languages/yli	Angguruk Yali (yli)
/languages/yml	Iamalele (yml)
/languages/yom	Kiyombi (yom)
/languages/yon	Yongkom (yon)
/languages/yor	Yorùbá (yor)
/languages/yrb	Yareba (yrb)
/languages/yre	Yaouré (yre)
/languages/yrl	Nhengatu (yrl)
/languages/yss	Yessan-Mayo (yss)
/languages/yua	Màaya (yua)
/languages/yue	Kwóng-tung wâ (yue)
/languages/yuj	Karkar-Yuri (yuj)
/languages/yut	Yopno (yut)
/languages/yva	Yawa (yva)
/languages/zaa	Sierra de Juárez Zapotec (zaa)
/languages/zab	Zapotec San Juan Guelavía (zab)
/languages/zac	Ocotlán Zapotec (zac)
/languages/zad	Cajonos Zapotec (zad)
/languages/zae	Yareni Zapotec (zae)
/languages/zai	Isthmus Zapotec (zai)
/languages/zaj	Zaramo / Zalamo (zaj)
/languages/zam	Miahuatlán Zapotec (zam)
/languages/zao	Ozolotepec Zapotec (zao)
/languages/zaq	Zapotec, Aloápam (zaq)
/languages/zar	Zapotec Rincón (zar)
/languages/zas	Santo Domingo Albarradas Zapotec (zas)
/languages/zat	Tabaa Zapotec (zat)
/languages/zav	Yatzachi Zapotec (zav)
/languages/zaw	Mitla Zapotec (zaw)
/languages/zca	Coatecas Altas Zapotec (zca)
/languages/zga	Kinga (zga)
/languages/zhn	Zhuang, Nong (zhn)
/languages/zho	简体中文 (zho)
/languages/zho	繁體中文 (zho_tw)
/languages/zia	Zia (zia)
/languages/ziw	Zigula (ziw)
/languages/zmb	Zimba (zmb)
/languages/zne	PaZande (zne)
/languages/zoc	Copainalá Zoque (zoc)
/languages/zom	Zo (zom)
/languages/zos	Francisco León Zoque (zos)
/languages/zpc	Choapan Zapotec (zpc)
/languages/zpg	didz-rieꞌ (zpg)
/languages/zpi	Santa María Quiegolani Zapotec (zpi)
/languages/zpl	Lachixío Zapotec (zpl)
/languages/zpm	Mixtepec Zapotec (zpm)
/languages/zpo	Zapotec Amatlán (zpo)
/languages/zpq	Zoogocho Zapotec (zpq)
/languages/zpt	San Vicente Coatlán Zapotec (zpt)
/languages/zpu	Yalálag Zapotec (zpu)
/languages/zpv	Chichicapan Zapotec (zpv)
/languages/zpz	Texmelucan Zapotec (zpz)
/languages/zrs	Mairasi (zrs)
/languages/zsm	Melayu, bahasa (zsm)
/languages/zsr	Southern Rincon Zapotec (zsr)
/languages/ztq	Quioquitani-Quierí Zapotec (ztq)
/languages/zty	Yatee Zapotec (zty)
/languages/zul	isiZulu (zul)
/languages/zyb	Zhuang, Yongbei (zyb)
/languages/zyp	Zyphe (zyp)
